


NO ./resources/north2.png

	SO ./resources/south2.png
	
WE ./resources/west2.png
EA ./resources/east2.png

  F                         255,100,0a
  C                                                     255,0,0

111111
100001111111
1100000000011
 110000000001
  11111111111
 
   1111111111
   1000000011111
   1000000000001
   10000N0010001
   1000000010001
   1000000100011
   1111111111111
