


NO ./resources/north2.png


            SO ./resources/south2.png

WE ./resources/west2.png
      EA ./resources/east2.png

  F                         154,            255,50
  C                                                     135,255,235


1111111111111111
1000000000000111
1000000000000011
100000000000001
100000000000001
100000000000001111111
100000000000000001111
100000000000001111111
1000000000000011111111
1000000000000000000001
1000000000000000000001
10000000000000N0000001
1000000000000000000001
1000000000000000000001
1000000000000011111101
1000000000000011   101
111111111111111    101
1111111111111111111111
