

			NO 					resources/no.jpg													
SO resources/so.jpg
WE resources/we.jpg


EA resources/ea.jpg

	F 255    , 100, 0



    		C 225, 255, 0
    		

     1111
111111
100011
1000011111111111111111111
111111 11101S1
1100011  11111
110111
111111       11111
    1111     1111
11111001
   11111
1
 
 
11111
10011
11111



