

NO 					no.jpg								
					
SO so.jpg
WE we.jpg


EA ea.jpg

F 255    , 100, 0



    		C 225, 255, 0













111111
100001
1000011111111111111111111
111111 111011
       1100011
       1101N1
       111111
    1111
11111001
   11111
   
   
   11111
   10001
   11111
 
   
   
   
   
   
   
   
   
   
   
   
